project path	projektipolku
Launch	Käynnistä
launch	käynnistää	Tyyliin: "Käynnistä ohjelma"
BiDi	kaksu	Lyhennelmä sanasta "kaksisuuntainen" :-)
operating system	käyttöjärjestelmä
SVN	versionhallinta	eng. "subversion"
cleanup	siistiminen
repository	pakettivarasto
script	komentosarja
manual	käyttöopas	kun viitataan OmegaT-manuaaliin
Acknowledgements	Kiitokset	aaa
Marc Prior	Marc Prior
Didier Briel	Didier Briel
Samuel Murray	Samuel Murray
Learn to use OmegaT in 5 minutes	Opi käyttämään OmegaT:tä viidessä minuutissa	Johdantokappaleen nimi, kirjoittaja Samuel MurrayWill Helton
Will Helton	Will Helton
Jean-Christophe Helary	Jean-Christophe Helary
OmegaT documentation tracker	OmegaT documentation tracker	OmegaT documentation tracke
spellcheck	oikeinkirjoituksen tarkistu	> oikeinkirjoituksen tarkistus
segment	segment	> segmentti
target	koh	> kohde
tag	tägi
remove	poista
mnemonic	muistisään	> muistisääntö
skip	ohita
shortcut	oikotie
search window	hakuikkuna	MUTTA: "search and replace" : _etsi_ ja korvaa
click	napsaut	> napsauta
search option	hakuasetu	> hakuasetus
Search and replace	etsi ja korvaa
TaaS	TaaS-palvelu
OmegaT	OmegaT
TaaS Terminology Lookup	TaaS-terminologiaha	> haku
legal notice	oikeudelli huomautu	> oikeudellinen huomautus
warranty	takuu
documentation	dokumentaatio
tracking system	seurantajäjestelmä
administration	ylläpito
LanguageTool	LanguageTool
spell check	oikeinkirjoituksen tarkistu	> oikeinkirjoituksen tarkistus
tokenizer	saneisti	> saneistin
tokenizer	saneisti	EI : saneistaja (sehän olisi henkilö!)
Afar	afar	aa
Abkhazian	abhaasi	ab
Achinese	atšeh	ace
Acoli	atšoli	ach
Adangme	adangme	ada
Adyghe	adyge	ady
Avestan	avesta	ae
Tunisian Arabic	tunisianarabia	aeb
Afrikaans	afrikaans	af
Afrihili	afrihili	afh
Aghem	aghem	agq
Ainu	ainu	ain
Akan	akan	ak
Akkadian	akkadi	akk
Alabama	alabama	akz
Aleut	aleutti	ale
Southern Altai	altai	alt
Amharic	amhara	am
Aragonese	aragonia	an
Old English	muinaisenglanti	ang
Angika	angika	anp
Arabic	arabia	ar
Modern Standard Arabic	yleisarabia	ar_001
Aramaic	valtakunnanaramea	arc
Mapuche	mapudungun	arn
Araona	araona	aro
Arapaho	arapaho	arp
Algerian Arabic	algerianarabia	arq
Arawak	arawak	arw
Moroccan Arabic	marokonarabia	ary
Egyptian Arabic	egyptinarabia	arz
Assamese	assami	as
Asu	asu	asa
American Sign Language	amerikkalainen viittomakieli	ase
Asturian	asturia	ast
Avaric	avaari	av
Awadhi	awadhi	awa
Kotava	kotava	avk
Aymara	aimara	ay
Azerbaijani	azeri	az
Azeri	azeri	az-short
Bashkir	baškiiri	ba
Baluchi	belutši	bal
Balinese	bali	ban
Bavarian	baijeri	bar
Basaa	basaa	bas
Bamun	bamum	bax
Batak Toba	batak-toba	bbc
Ghomala	ghomala	bbj
Belarusian	valkovenäjä	be
Beja	bedža	bej
Bemba	bemba	bem
Betawi	betawi	bew
Bena	bena	bez
Bafut	fut	bfd
Badaga	badaga	bfq
Bulgarian	bulgaria	bg
Western Balochi	länsibelutši	bgn
Bhojpuri	bhodžpuri	bho
Bislama	bislama	bi
Bikol	bikol	bik
Bini	bini	bin
Banjar	banjar	bjn
Kom	kom	bkm
Siksika	siksika	bla
Bambara	bambara	bm
Bangla	bengali	bn
Tibetan	tiibet	bo
Bishnupriya	bišnupria	bpy
Bakhtiari	bahtiari	bqi
Breton	bretoni	br
Braj	bradž	bra
Brahui	brahui	brh
Bodo	bodo	brx
Bosnian	bosnia	bs
Akoose	koose	bss
Buriat	burjaatti	bua
Buginese	bugi	bug
Bulu	bulu	bum
Blin	bilin	byn
Medumba	medumba	byv
Catalan	katalaani	ca
Caddo	caddo	cad
Carib	karibi	car
Cayuga	cayuga	cay
Atsam	atsam	cch
Chechen	tšetšeeni	ce
Cebuano	cebuano	ceb
Chiga	kiga	cgg
Chamorro	tšamorro	ch
Chibcha	tšibtša	chb
Chagatai	tšagatai	chg
Chuukese	chuuk	chk
Mari	mari	chm
Chinook Jargon	chinook-jargon	chn
Choctaw	choctaw	cho
Chipewyan	chipewyan	chp
Cherokee	cherokee	chr
Cheyenne	cheyenne	chy
Central Kurdish	sorani	ckb
Corsican	korsika	co
Coptic	kopti	cop
Capiznon	capiznon	cps
Cree	cree	cr
Crimean Turkish	krimintataari	crh
Crimean Turkish	kriminturkki	crh-secondary
Czech	tšekki	cs
Kashubian	kašubi	csb
Church Slavic	kirkkoslaavi	cu
Chuvash	tšuvassi	cv
Welsh	kymri	cy
Danish	tanska	da
Dakota	dakota	dak
Dargwa	dargi	dar
Taita	taita	dav
German	saksa	de
Austrian German	itävallansaksa	de_AT
Swiss High German	sveitsinyläsaksa	de_CH
Delaware	delaware	del
Slave	slevi	den
Dogrib	dogrib	dgr
Dinka	dinka	din
Zarma	djerma	dje
Dogri	dogri	doi
Lower Sorbian	alasorbi	dsb
Central Dusun	dusun	dtp
Duala	duala	dua
Middle Dutch	keskihollanti	dum
Divehi	divehi	dv
Jola-Fonyi	jola-fonyi	dyo
Dyula	djula	dyu
Dzongkha	dzongkha	dz
Dazaga	dazaga	dzg
Embu	embu	ebu
Ewe	ewe	ee
Efik	efik	efi
Emilian	emilia	egl
Ancient Egyptian	muinaisegypti	egy
Ekajuk	ekajuk	eka
Greek	kreikka	el
Elamite	elami	elx
English	englanti	en
Australian English	australianenglanti	en_AU
Canadian English	kanadanenglanti	en_CA
British English	britannianenglanti	en_GB
UK English	englanti (Britannia)	en_GB-short
American English	amerikanenglanti	en_US
US English	englanti (USA)	en_US-short
Middle English	keskienglanti	enm
Esperanto	esperanto	eo
Spanish	espanja	es
Latin American Spanish	amerikanespanja	es_419
European Spanish	euroopanespanja	es_ES
Mexican Spanish	meksikonespanja	es_MX
Central Yupik	alaskanjupik	esu
Estonian	viro	et
Basque	baski	eu
Ewondo	ewondo	ewo
Extremaduran	extremadura	ext
Persian	farsi	fa
Fang	fang	fan
Persian	persia	fa-secondary
Fanti	fanti	fat
Fulah	fulani	ff
Finnish	suomi	fi
Filipino	filipino	fil
Tornedalen Finnish	meänkieli	fit
Fijian	fidži	fj
Faroese	fääri	fo
Fon	fon	fon
French	ranska	fr
Canadian French	kanadanranska	fr_CA
Swiss French	sveitsinranska	fr_CH
Cajun French	cajun	frc
Middle French	keskiranska	frm
Old French	muinaisranska	fro
Arpitan	arpitaani	frp
Northern Frisian	pohjoisfriisi	frr
Eastern Frisian	itäfriisi	frs
Friulian	friuli	fur
Western Frisian	länsifriisi	fy
Irish	iiri	ga
Ga	ga	gaa
Gagauz	gagauzi	gag
Gan Chinese	gan-kiina	gan
Gayo	gajo	gay
Gbaya	gbaja	gba
Zoroastrian Dari	zoroastrialaisdari	gbz
Scottish Gaelic	gaeli	gd
Geez	ge’ez	gez
Gilbertese	kiribati	gil
Galician	galicia	gl
Gilaki	gilaki	glk
Middle High German	keskiyläsaksa	gmh
Guarani	guarani	gn
Old High German	muinaisyläsaksa	goh
Goan Konkani	goankonkani	gom
Gondi	gondi	gon
Gorontalo	gorontalo	gor
Gothic	gootti	got
Grebo	grebo	grb
Ancient Greek	muinaiskreikka	grc
Swiss German	sveitsinsaksa	gsw
Gujarati	gudžarati	gu
Wayuu	wayuu	guc
Frafra	frafra	gur
Gusii	gusii	guz
Manx	manksi	gv
Gwichʼin	gwitšin	gwi
Hausa	hausa	ha
Haida	haida	hai
Hakka Chinese	hakka-kiina	hak
Hawaiian	havaiji	haw
Hebrew	heprea	he
Hindi	hindi	hi
Fiji Hindi	fidžinhindi	hif
Hiligaynon	hiligaino	hil
Hittite	heetti	hit
Hmong	hmong	hmn
Hiri Motu	hiri-motu	ho
Croatian	kroatia	hr
Upper Sorbian	yläsorbi	hsb
Xiang Chinese	xiang-kiina	hsn
Haitian Creole	haiti	ht
Hungarian	unkari	hu
Hupa	hupa	hup
Armenian	armenia	hy
Herero	herero	hz
Interlingua	interlingua	ia
Iban	iban	iba
Ibibio	ibibio	ibb
Indonesian	indonesia	id
Interlingue	interlingue	ie
Igbo	igbo	ig
Sichuan Yi	sichuanin-yi	ii
Inupiaq	inupiaq	ik
Iloko	iloko	ilo
Ingush	inguuši	inh
Ido	ido	io
Icelandic	islanti	is
Italian	italia	it
Inuktitut	inuktitut	iu
Ingrian	inkeroinen	izh
Japanese	japani	ja
Jamaican Creole English	jamaikankreolienglanti	jam
Lojban	lojban	jbo
Ngomba	ngomba	jgo
Machame	machame	jmc
Judeo-Persian	juutalaispersia	jpr
Judeo-Arabic	juutalaisarabia	jrb
Jutish	juutti	jut
Javanese	jaava	jv
Georgian	georgia	ka
Kara-Kalpak	karakalpakki	kaa
Kabyle	kabyyli	kab
Kachin	katšin	kac
Jju	jju	kaj
Kamba	kamba	kam
Kawi	kavi	kaw
Kabardian	kabardi	kbd
Kanembu	kanembu	kbl
Tyap	tyap	kcg
Makonde	makonde	kde
Kabuverdianu	kapverdenkreoli	kea
Kenyang	kenyang	ken
Koro	norsunluurannikonkoro	kfo
Kongo	kongo	kg
Kaingang	kaingang	kgp
Khasi	khasi	kha
Khotanese	khotani	kho
Koyra Chiini	koyra chiini	khq
Khowar	khowar	khw
Kikuyu	kikuju	ki
Kirmanjki	kirmanjki	kiu
Kuanyama	kuanjama	kj
Kazakh	kazakki	kk
Kako	kako	kkj
Kalaallisut	kalaallisut	kl
Kalenjin	kalenjin	kln
Kalaallisut	grönlanti	kl-secondary
Khmer	khmer	km
Kimbundu	kimbundu	kmb
Kannada	kannada	kn
Korean	korea	ko
Komi-Permyak	komipermjakki	koi
Konkani	konkani	kok
Kosraean	kosrae	kos
Kpelle	kpelle	kpe
Kanuri	kanuri	kr
Karachay-Balkar	karatšai-balkaari	krc
Krio	krio	kri
Kinaray-a	kinaray-a	krj
Karelian	karjala	krl
Kurukh	kurukh	kru
Kashmiri	kašmiri	ks
Shambala	shambala	ksb
Bafia	bafia	ksf
Colognian	kölsch	ksh
Kurdish	kurdi	ku
Kumyk	kumykki	kum
Kutenai	kutenai	kut
Komi	komi	kv
Cornish	korni	kw
Kyrgyz	kirgiisi	ky
Latin	latina	la
Ladino	ladino	lad
Ladino	juutalaisespanja	lad-secondary
Langi	lango	lag
Lahnda	lahnda	lah
Lamba	lamba	lam
Luxembourgish	luxemburg	lb
Lezghian	lezgi	lez
Lingua Franca Nova	lingua franca nova	lfn
Ganda	ganda	lg
Limburgish	limburg	li
Ligurian	liguuri	lij
Livonian	liivi	liv
Lakota	lakota	lkt
Lombard	lombardi	lmo
Lingala	lingala	ln
Lao	lao	lo
Mongo	mongo	lol
Lozi	lozi	loz
Northern Luri	pohjoisluri	lrc
Lithuanian	liettua	lt
Latgalian	latgalli	ltg
Luba-Katanga	katanganluba	lu
Luba-Lulua	luluanluba	lua
Luiseno	luiseño	lui
Lunda	lunda	lun
Luo	luo	luo
Mizo	lusai	lus
Luyia	luhya	luy
Latvian	latvia	lv
Literary Chinese	klassinen kiina	lzh
Laz	lazi	lzz
Madurese	madura	mad
Mafa	mafa	maf
Magahi	magahi	mag
Maithili	maithili	mai
Makasar	makassar	mak
Mandingo	mandingo	man
Masai	maasai	mas
Maba	maba	mde
Moksha	mokša	mdf
Mandar	mandar	mdr
Mende	mende	men
Meru	meru	mer
Morisyen	morisyen	mfe
Malagasy	malagassi	mg
Middle Irish	keski-iiri	mga
Makhuwa-Meetto	makua-meetto	mgh
Metaʼ	meta’	mgo
Marshallese	marshall	mh
Maori	maori	mi
Mi’kmaq	micmac	mic
Minangkabau	minangkabau	min
Macedonian	makedonia	mk
Malayalam	malajalam	ml
Mongolian	mongoli	mn
Manchu	mantšu	mnc
Manipuri	manipuri	mni
Mohawk	mohawk	moh
Mossi	mossi	mos
Marathi	marathi	mr
Western Mari	vuorimari	mrj
Malay	malaiji	ms
Maltese	malta	mt
Mundang	mundang	mua
Creek	creek	mus
Mirandese	mirandeesi	mwl
Marwari	marwari	mwr
Mentawai	mentawai	mwv
Burmese	burma	my
Myene	myene	mye
Erzya	ersä	myv
Mazanderani	mazandarani	mzn
Nauru	nauru	na
Min Nan Chinese	min nan -kiina	nan
Neapolitan	napoli	nap
Nama	nama	naq
Norwegian Bokmål	norjan bokmål	nb
North Ndebele	pohjois-ndebele	nd
Low German	alasaksa	nds
Low Saxon	alankomaidenalasaksa	nds_NL
Nepali	nepali	ne
Newari	newari	new
Ndonga	ndonga	ng
Nias	nias	nia
Niuean	niue	niu
Ao Naga	ao naga	njo
Dutch	hollanti	nl
Flemish	flaami	nl_BE
Kwasio	kwasio	nmg
Norwegian Nynorsk	norjan nynorsk	nn
Ngiemboon	ngiemboon	nnh
Norwegian	norja	no
Nogai	nogai	nog
Old Norse	muinaisnorja	non
Novial	novial	nov
N’Ko	n’ko	nqo
South Ndebele	etelä-ndebele	nr
Northern Sotho	pohjoissotho	nso
Nuer	nuer	nus
Navajo	navajo	nv
Classical Newari	klassinen newari	nwc
Nyanja	njandža	ny
Nyamwezi	nyamwezi	nym
Nyankole	nyankole	nyn
Nyoro	nyoro	nyo
Nzima	nzima	nzi
Occitan	oksitaani	oc
Ojibwa	odžibwa	oj
Oromo	oromo	om
Odia	orija	or
Ossetic	osseetti	os
Osage	osage	osa
Ottoman Turkish	osmani	ota
Punjabi	pandžabi	pa
Pangasinan	pangasinan	pag
Pahlavi	pahlavi	pal
Pampanga	pampanga	pam
Papiamento	papiamentu	pap
Palauan	palau	pau
Picard	picardi	pcd
Pennsylvania German	pennsylvaniansaksa	pdc
Plautdietsch	plautdietsch	pdt
Old Persian	muinaispersia	peo
Palatine German	pfaltsi	pfl
Phoenician	foinikia	phn
Pali	paali	pi
Polish	puola	pl
Piedmontese	piemonte	pms
Pontic	pontoksenkreikka	pnt
Pohnpeian	pohnpei	pon
Prussian	muinaispreussi	prg
Old Provençal	muinaisprovensaali	pro
Pashto	paštu	ps
Portuguese	portugali	pt
Brazilian Portuguese	brasilianportugali	pt_BR
European Portuguese	euroopanportugali	pt_PT
Quechua	ketšua	qu
Kʼicheʼ	kʼicheʼ	quc
Chimborazo Highland Quichua	chimborazonylänköketšua	qug
Rajasthani	radžastani	raj
Rapanui	rapanui	rap
Rarotongan	rarotonga	rar
Romagnol	romagnoli	rgn
Riffian	tarifit	rif
Romansh	retoromaani	rm
Rundi	rundi	rn
Romanian	romania	ro
Moldavian	moldova	ro_MD
Rombo	rombo	rof
Romany	romani	rom
Root	juuri	root
Rotuman	rotuma	rtm
Russian	venäjä	ru
Rusyn	ruteeni	rue
Roviana	roviana	rug
Aromanian	aromania	rup
Kinyarwanda	ruanda	rw
Rwa	rwa	rwk
Sanskrit	sanskrit	sa
Sandawe	sandawe	sad
Sakha	jakuutti	sah
Samaritan Aramaic	samarianaramea	sam
Samburu	samburu	saq
Sasak	sasak	sas
Santali	santali	sat
Saurashtra	sauraštri	saz
Ngambay	ngambay	sba
Sangu	sangu	sbp
Sardinian	sardi	sc
Sicilian	sisilia	scn
Scots	skotti	sco
Sindhi	sindhi	sd
Sassarese Sardinian	sassarinsardi	sdc
Southern Kurdish	eteläkurdi	sdh
Northern Sami	pohjoissaame	se
Seneca	seneca	see
Sena	sena	seh
Sri	seri	sei
Selkup	selkuppi	sel
Koyraboro Senni	koyraboro senni	ses
Sango	sango	sg
Old Irish	muinaisiiri	sga
Samogitian	samogiitti	sgs
Serbo-Croatian	serbokroaatti	sh
Tachelhit	tašelhit	shi
Shan	shan	shn
Chadian Arabic	tšadinarabia	shu
Sinhala	sinhala	si
Sidamo	sidamo	sid
Slovak	slovakki	sk
Slovenian	sloveeni	sl
Lower Silesian	sleesiansaksa	sli
Selayar	selayar	sly
Samoan	samoa	sm
Southern Sami	eteläsaame	sma
Lule Sami	luulajansaame	smj
Inari Sami	inarinsaame	smn
Skolt Sami	koltansaame	sms
Shona	šona	sn
Soninke	soninke	snk
Somali	somali	so
Sogdien	sogdi	sog
Albanian	albania	sq
Serbian	serbia	sr
Sranan Tongo	sranan	srn
Serer	serer	srr
Swati	swazi	ss
Saho	saho	ssy
Southern Sotho	eteläsotho	st
Saterland Frisian	saterlandinfriisi	stq
Sundanese	sunda	su
Sukuma	sukuma	suk
Susu	susu	sus
Sumerian	sumeri	sux
Swedish	ruotsi	sv
Swahili	swahili	sw
Congo Swahili	kingwana	sw_CD
Comorian	komori	swb
Classical Syriac	muinaissyyria	syc
Syriac	syyria	syr
Silesian	sleesia	szl
Tamil	tamili	ta
Tulu	tulu	tcy
Telugu	telugu	te
Timne	temne	tem
Teso	teso	teo
Tereno	tereno	ter
Tetum	tetum	tet
Tajik	tadžikki	tg
Thai	thai	th
Tigrinya	tigrinja	ti
Tigre	tigre	tig
Tiv	tiv	tiv
Turkmen	turkmeeni	tk
Tokelau	tokelau	tkl
Tsakhur	tsahuri	tkr
Tagalog	tagalog	tl
Klingon	klingon	tlh
Tlingit	tlingit	tli
Talysh	tališi	tly
Tamashek	tamašek	tmh
Tswana	tswana	tn
Tongan	tonga	to
Nyasa Tonga	malawintonga	tog
Tok Pisin	tok-pisin	tpi
Turkish	turkki	tr
Turoyo	turojo	tru
Taroko	taroko	trv
Tsonga	tsonga	ts
Tsakonian	tsakonia	tsd
Tsimshian	tsimši	tsi
Tatar	tataari	tt
Muslim Tat	tati	ttt
Tumbuka	tumbuka	tum
Twi	twi	tw
Tuvalu	tuvalu	tvl
Tasawaq	tasawaq	twq
Tahitian	tahiti	ty
Tuvinian	tuva	tyv
Central Atlas Tamazight	keskiatlaksentamazight	tzm
Udmurt	udmurtti	udm
Uyghur	uiguuri	ug
Ugaritic	ugarit	uga
Ukrainian	ukraina	uk
Umbundu	mbundu	umb
Urdu	urdu	ur
Uzbek	uzbekki	uz
Walloon	valloni	wa
Walser	walser	wae
Vai	vai	vai
Wolaytta	wolaitta	wal
Waray	waray	war
Washo	washo	was
Warlpiri	warlpiri	wbp
Venda	venda	ve
Venetian	venetsia	vec
Veps	vepsä	vep
Vietnamese	vietnam	vi
West Flemish	länsiflaami	vls
Main-Franconian	maininfrankki	vmf
Volapük	volapük	vo
Wolof	wolof	wo
Votic	vatja	vot
Võro	võro	vro
Vunjo	vunjo	vun
Wu Chinese	wu-kiina	wuu
Kalmyk	kalmukki	xal
Xhosa	xhosa	xh
Mingrelian	mingreli	xmf
Soga	soga	xog
Yao	jao	yao
Yapese	japi	yap
Yangben	yangben	yav
Yemba	yemba	ybb
Yiddish	jiddiš	yi
Yoruba	joruba	yo
Nheengatu	ñeengatú	yrl
Cantonese	kantoninkiina	yue
Zhuang	zhuang	za
Zapotec	zapoteekki	zap
Blissymbols	blisskieli	zbl
Zeelandic	seelanti	zea
Zenaga	zenaga	zen
Standard Moroccan Tamazight	vakioitu tamazight	zgh
Chinese	kiina	zh
Simplified Chinese	yksinkertaistettu kiina	zh_Hans
Traditional Chinese	perinteinen kiina	zh_Hant
Zulu	zulu	zu
Zuni	zuni	zun
No linguistic content	ei kielellistä sisältöä	zxx
Zaza	zaza	zza
user's Manual	käyttöopas	OmegaT:n ohje. Englanniksi Users manual, user manual, tai vaikka pelkkä manual
without spaces	ilman välilyöntejä
including spaces	sis. välilyönnit
project specific	projektikohtainen
editor pane	muokkausruu	> muokkausruutu
auto-completer	automaattin korvau	> automaattinen korvaus
auto-completer	automaattisen korvauksen valintaikkuna
auto-text entries	autom. tekstikohdat
Java .properties file	Java-ominaisuuksien tiedosto (.properties)
stdout	stdout-tuloste
Copy Files to Source Folder...	Kopioi lähdekansioon…	button = painike
Files to translate	Käännettävät tiedostot	käyttöoppaan kohta
File formats	Tiedostomuodot	käyttöoppaan kohdan "Käännettävät tiedostot" alakohta
Mapping	yhdistäminen	esim. paikallinen kansio yhdistetään etäkansioon
Source files folder	lähdetiedostojen kansio
Translated files folder	käännettyjen tiedostojen kansio
Dictionary files folder	Sanakirjojen kansio
An error occurred	tapahtui virhe	An error occurred while B-ing --> B:ssä tapahtui virhe
Regular expressions	Säännölliset lausekkeet
Regular expression	Säännöllinen lauseke	EI: säännönMUKAINEN lauseke
Advanced Options	lisäasetukset
Subtitles	tekstitys
Subtitles	tekstitys
Glossary files folder	termilistatiedostojen kansio
Writeable glossary file folder	kirjoituskelpoisen termilistan kansio
Writeable glossary	kirjoituskelpoinen termilista
domain	aihepiiri	Esimerkki käytöstä: TaaS-aihepiiri
TaaS domain	TaaS-aihepiiri
Whitespace	Tyhjätila
Whitespace character	Tyhjätilamerkki
shortcut	näppäinyhdistelmä	kun on kyse esim CTRL+M
close block	loppulohko
Escaped character	Koodinvaihtomerkki
Escaped character	Kenoviiva
Translation unit	Käännösyksikkö
plugin	liitännäi	> liitännäinen
filter threw an exception	suodatin aiheutti poikkeuksen
threw an exception	aiheutti poikkeuksen	käyttö: XXX aiheutti poikkeuksen
Java Resource Bundles	Java-resurssiniput
unescape	kääntää	Java-funktio unescape() kääntää ASCII-merkinnän tavan kielelle
escape	unescape	JavaScriptin sisäänrakkettu funktio Escape() palauttaa merkin ASCII-merkinnän
slide masters	dian perustyylit	PowerPointissa!
LGPL License	lisenssi: LGPL
License	lisenssi
Source File Encoding	lähdetiedoston merkistökoodaus
HTML	HTML
XHTML	XHTML
encoding declaration	maininta merkistökoodauksesta
Error saving	_ tallentamisessa tapahtui virhe
Pattern	rakenne	mallikuvio
segmentation rules	segmentointisäännöt
printf-variable	printf-muuttuja
Fuzzy Matches	Sumeat osumat
fuzzy Match	sumea osuma
Git	Git
team project	ryhmäprojekti
Master Password	pääsalasana
Glossary viewer	Sanaston esikatselu
form-feed character	sivunvaihdon merkki
shortcut definition file	pikanäppäinten kuvaustiedosto
modifier	muuntonäppäin	vaihto- ctrl- tai alt-näppäin
modifier key	muuntonäppäin	vaihto- ctrl- tai alt-näppäin
